__________
|HH TV  D|
|        |
|        |
|   TA 8 |
|   BL   |
|        |
|        |
|__  ____|
